SO         ./tex/greystone.xpm

WE        ./tex/purplestone.xpm


EA  ./tex/red.xpm


C  255, 120, 000

NO  ./tex/eagle.xpm
F  100, 000, 00

11111111111111
100000000000011
100000000000011
1000100N0000011
100000000000011
100000000000011
11111111111111