NO ./tex/eagle.xpm
WE ./tex/purplestone.xpm
SO ./tex/greystone.xpm
EA  ./tex/red.xpm


C  430, 144, 172
F   101,283,83

  111111111
11111111111111111111111111111111111111111111111111111111111
100000000000000000000000000000000000000000000010000000000011
1000000000000000001000000000000000000000000000100000000000011
1000000000000000001000000000000000000000000000100000000000011
1000000000000001111000000000000000000000000000100000000000011
1000000000000000000000000000000000000000000000100000000000011
1000000000000000000011000000000000000000000000000000000000011
1000000000000000000011000000000000000000000000000000000000011
1000000010000000000000000000000000000000000000000000000000011
1000000010000000000000000011111100000000000000000000000000011
1111111110000000000000000010000100000000000000000000000000011
1000000010000000100000000011111100000000000000000000000000011
100000001000000010000000000000000000000000000000000000000001
1000000000000000100000000011111100000000100000000010000000011
100000000000000010000000000000000000000010000000001000000001
1000000000000000100000000011111100000000100000000010000000011
100000010000000000000000000000000000000010000000001000000001
1000000100000000000000000011111100000000100000000010000000011
100000010000000000000000000000000000000000000000000000000001
1000000100000000000000000011111100000000000000000000000000011
100000010000000000000000000000000000000000000000000000000001
1000000000000000000000000011111100000000000000000000000000011
100000010000000000000000000000000000000000000001000000000001
100000010000000000000000001111110000000000000001000000E000011
100000010000000000000000000000000000000000000001000000000001
1000000100000000000000000011111100000000000000010000000000011
100000010000000000000000000000000000000000000001000000000001
11111111111111111111111111111111111111111111111111111111111 