NO ./tex/eagle.xpm
WE ./tex/purplestone.xpm
SO ./tex/greystone.xpm
EA  ./tex/red.xpm


C  430, 144, 172
F   101,283,83


    11111
111100N01
11100001111111111111111111
  100000000000000000000001
  100011100000000000001011
   11001 1000000111111111111111
   11111 10000001          11
         10000001
    11111100000011111111111111
    100000000000000000001
    100000111110000000001
    100000000000000000001
    100000000000000000001
    111111111111111111111